XXXXXfXXXXX
XXXXXXXXXXX
XXXXXXXXXXX
XXXXXQXEXXX
XXXXQXXXXXX
XXQXXXXXXXX
XXXXwXXXXXX
XXXXXXqqXXX
XXXXXXXXXQX
XXXXXXXqXXX
XXQXXEXXqXX
QXXXXXXXXXq
XXXXXXXXXXX
XexXXXXXXEX
XxxqqrQQXXX
