WQXXXfXXXWQ
QQXXXXXqXQQ
XXXXXXQXXwX
XXXXXXXXXXX
XXXXXXXXEXX
XXXXXQXXXXX
XXXXeXXQXXX
XXXXXWXXXXX
XQXqXqXXXXX
XXXXwqqeXXX
qXXXXWXXXXq
XQXXXXXXXQX
XXqXXXXXqXX
XXXQXXXQXXX
XXXXXrXXXXX
