XXXXXFXXXXX
XXXXXXXXXXX
XQqXXXXqXXX
XXXXXXXXXXX
qXXXXXwXXXX
XXXXXXXXXQX
XQXXXXXXXXX
XXXXXXXXXXX
QXXXXEXXeXX
XQXXXXXXXXX
XXQXXXXXXXX
XXXqXXXXXXX
XXXXQXXXXXX
XXXXXXXXXXX
XXXXXRXXXXX
