XXXXXfXXXXX
XeXXXXXXXqX
XXXXXXXXqXX
XXXXXXXqXXX
XXXXXqqXXXX
XXXXXxXXXXX
XqXXXXXXXXX
XXqqXXXXXXX
XXXXqXXXXXX
XXXXXqqqXXX
XXXXXXXXXXX
XXXXXXXXXXq
XXeXXXXXXqX
XXXXXXqqqXX
XXXXXrXXXXX
