XXXXXfXXXXX
XXXXXXXXXXX
XXXXQXXXXXX
XXXXXXqXXXX
XXXXXXXXWXX
XXXXXXXQXXX
XXXXXXXXXXX
XXXXXEXXXXX
XXQXXXXXqXX
XXXXXXXXxXX
QXXXXXXXXXq
XqXXXXXXXQX
XXqXXXXXQXX
XXXqXXXQXXX
XXXXXrXXXXX
