XXXXXfXXXXX
XXXXXXXXXXX
XXXqXXXxXXX
QXQxXXXxXXX
XXXXXXXXXXX
XqXXXeXwXXX
XXXqXXXxxxx
XXXqXXXxxwx
XXXXXXXWxxx
XXXXXXXXXXX
XqXqXEXxXxX
XXXqXXXxXXX
qXXXXXXXXXx
XqXXXXXXXxX
XXXqXrXxXXX
