XXXXXfXXXXX
XeXXXXXXXeX
XXXXXXXXXXX
XXXXXqXXXXX
XXQqQqQqXXX
qXXXXXXXXXX
QwXXXXXXXXX
XXXQqXqXqXX
XXXXXXXXXXq
XXXXXXXXXqX
XXXXXXXXQXX
XXXXXXXQXXX
XXXXXXQXXXX
XXXXXXXXXXX
XXXXXrXXXXX
