XXXXXfXXXXX
XXXXXXXXXXX
XXXXXXXXXXX
XXXXXXEXXXX
XXXXXXXXXXX
XXXXQqXXXeX
XXXXXQXXXXX
QXXWXxxxXXX
qXXXXxexWXX
QXXXXxxxXXX
XqXXXXXXXXX
XXQXXXXXEXX
XXwXXXXXXXX
XXXXqXXXXeX
XXXXXrXXXXX
