XXXXXfXXXXX
XXXXXXXXXXX
XXXXXXXXXXX
XXXXXXXXXXX
XXXQXEXXXXX
QXXXXXXXXXX
XXXXXXXXXXX
xqQqQqQqqXX
XXXXXXXXXXX
XXXXXXXXXXq
XXQQqQqQqQX
XXXXXXXXXXX
qXXXXXXXXXX
XQqQqXXXXXX
XXXXXrXXXXX
