XXXXXfXXXXX
XXXXXXXXXXX
XXXXXQXXXXX
XXXXXXXXXXX
XXXXqXQXXXX
XXXXXXXXXXX
qXQXXXXXqXQ
XXXXXEXXXXX
qXXXXXXXXXQ
XXXXXXXXXXX
qXXXXXXXXXQ
XXxxxXXXXXX
qXxwXXWXXXQ
XqxXXXXXXQX
QqQqXrXQqQq
