XXXXXfXXXXX
XXXXXXXXXXX
XXXEXXXEXXX
XXXXXXXXXXX
XXEXQXXXEXX
XXXXQXXXXXX
XwXXXXXXXwX
XXXEXXXEXXX
XwXXQXXXwXX
XXXXXXXXXXX
XXXEXXXEXXX
XwXXXXXXXXX
XXXXXXXXXwX
XXXEXXXEXXX
XXXXXrXXXXX
