XXXXXFXXXXX
XXXXXXXXXXX
XXXXXXXXXXX
QXQXqXQXqXq
XXXXXXXXXXX
XQXEeEeEXqX
XXXeeeeeXXX
QXXEeeeEXXq
XXXeeeeeXXX
XQXEeEeEXqX
XXXXXXXXXXX
QXXXXXXXXXq
XXXXXXXXXXX
XqXqXXXQXQX
XXXXXRXXXXX
