XXXXXFXXXXX
XXXXXXXXXXX
XXXXXXXXXXX
XXXXXXXXXXX
XXXQXEXqXXX
WXXXXXXXXwX
XXXXXeXXXXX
XXWXXXXwXXX
XXqqXXXQQXX
QXXXXXXXXXq
XXwxXXXWxXX
XQQQXXXqqqX
XXXXXXXXXXX
qXXXXXXXXXQ
XqXqXRXQXQX
