XXXXXFXXXXX
XXXXXXXXXXX
XXXXXXQXXqX
XqXXXXXXXXX
XXXXXqXXXXQ
QXXXXXXXXXX
XXXXXwXXXqX
XqXXXXXXXXX
XXXXXXXXXXQ
QXXXXXXXXXX
XXXXXWXXXqX
XqXXXXXXXXX
XXXXXXXXQXQ
QqQqXXXXXqX
XXXXXRXXXXX
