qXXXXFXXXXQ
QXXXXXXXXXq
qXXQXXXqXXQ
QXXXXXXXXXq
qXXQXEXqXXQ
QXXXXXXXXqq
qXXqXXXXXXQ
QqXXXXXXXqq
qXqXXXXXQXQ
QXXXXXXXXXq
qXXQXeXqXXQ
QqXXXXXXXQq
qxqxXXXXQXQ
QxwxXXXWXXq
qxxxXRXXXXQ
