QQXXQFQXXQQ
QQXXXXXXXQQ
QXXQXXXqXXQ
XXQXQXqXqXX
QXXXXQXXXXq
qqwXXXXWQQQ
XXXqXqXQXXX
XEXqXXXQXeX
XXwqqXQWXXX
qqqXXXXXQQQ
XXXXXQXXXXX
XXXXQXQXXXX
QXXQXXXqXXq
qqXXXXXXXQQ
qqqqqRQQQQQ
