XXXXXFXXXXX
XXXXXXXXXXX
XXXXXXXXXXX
XQXXqXXXXqX
XXXXXXXXXXX
qXXXXXXXXXQ
XXXXXeXXXXX
WXXXXXXXXwX
XXXXXXXXXXX
XXXXXEXXXXX
XXXQXXXXXwX
XXXXXXXXXXX
XwXXXXXXWXX
XXXWXXwXXXX
XXXXXRXXXXX
