XXXXXfXXXXX
XEXXXXXXXEX
XeXXXXXXXeX
XEXwXXXXXEX
XeXXXXWXXeX
XEXXXXXXXEX
XeXwXXXXXeX
XEXXXXXXXEX
XeXXXXWXXeX
XEXXXXXXXEX
XeXwXXXXXeX
XEXXXXXXXEX
XeXXXXWXXeX
XEXXXXXXXEX
XXXXXrXXXXX
