XXXXXfXXXXX
XXXXXXXXXXX
XXXXXXXXXXX
QXqXqXXXXXX
XXXXXXXXXXX
qXXXXXXXXXX
XXXXXXXXXXX
QXXXXXXXXXX
XXQXeXWXqXX
XXXXXXXXXXX
WXXXXXXXXWX
XwXXXXXXwXX
XwWXXXXWwXX
XXXXXXXXXXX
XXXXXrXXXXX
