wXqXXFXXQWX
XXXXXXXXXXX
XXXXXXXXXXX
XXXXXXXXXXX
XXXXXqXXXXX
XXqXXXXXQXX
XXXXXXXXXXX
XXXXXEXXXXX
XQXQXXXqXqX
XXXXXXXXXXX
qXXXXXXXXXQ
XXQXXXXXqXX
XXXXXXXXXXX
wXXXXXXXXWX
XXqXXRXXQXX
