XXXXXfXXXXX
XXXXXXXXXXX
XXXXXXXXXXX
XXXXXqXXXXX
XXXXQXqXXXX
XXXXXXXXXXX
XeXXXqXXXEX
XXXXWwXXXXX
XXXXXXXXXXX
XXXQXXXqXXX
QXXXXXXXXXq
XqXXXXXXXQX
XXXqXXXQXXX
XXXXXXXXXXX
XXXXXrXXXXX
