QXXXXfXXXXq
QxxxXXXXXXq
QxExXQXXeXq
QxxxXXXXXXq
QXXXqXXXXXq
QXeXXqXXEXq
QXXXXXXXXXq
QXXXXXQXXXq
QXEXXQXXeXq
QXXXXXXXXXq
QXXXqXXXXXq
QXeXXQXXEXq
QXXXXXXXXXq
QQWXqXQwXqq
QQXXXrXXXqq
