XXXXXfXXXXX
XXXXXXXXXXX
XXXXXXXXXXX
XXXXXXXXXXX
XXXQXEXXXXX
QXXXXXXXXXX
XXXXXXXXXXX
xqQqQqQqQqX
XXXXXXXXXXX
XXXXXXXXXXq
XQqQqQqQqQX
XXXXXXXXXXX
qXXXXXXXXXX
XQqQqXXXXXX
XXXXXrXXXXX
