wWwWXfwWwWX
XXXXXXXXXXX
XXXXqXQXXXX
XXXXqXQXXXX
XXXXqXQXXXX
XXXXqXQXXXX
XXXXqXQXXXX
XXXXqXQXXXX
XXXXqXQXXXX
XXXXqXQXXXX
XXXXqXQXXXX
XXXXqXQXXXX
XXXXqXQXXXX
wWwWXXwWwWX
qXXXXrXXXXX
