XXXXXfXXXXX
XEXXXXXXXXX
XXXXXXWXXXX
XXXXXXXXXXX
XXwXXXXXXEX
XXXXXXXXXXX
XXXXXWXXXXX
XXXXXXXXXeX
XXXXXXXXXXX
wXXXXWXXXXX
XXXXXXXXXXX
XXqXXXXXXXX
XXXqXXXXXEX
XXXXqXXXXXX
XXXXXrXXXXX
