XXXXXfXXXXX
XeXXXXXXXEX
XXXXXXXXXXX
XXXXqXQXXXX
XXXXXQXXXXX
XXXXQXqXXXX
XXXXXXXXXXX
wXXXXXXXXWX
XXXXXXXXXXX
XXXXXXXXXXX
XXXXXQXXXXX
qqqXXXXXQQQ
XXXXXXXXXXX
qqqqqXQQQQQ
XXXXXrXXXXX
