XXXXXfXXXXX
XeXXXXXXXEX
XXXXXXXXXXX
XXXXXXQXXXX
XXXXXQXXXXX
XXXXQXqXXXX
XXXXXXXXXXX
wXXXXXXXXWX
XXXXXXXXXXX
XXXXQQQXXXX
XXXXXXXXXXX
qqqXXXXXQQQ
XXXXXXXXXXX
qqqqqXQQQQQ
XXXXXrXXXXX
