XXXXXfXXXXX
XXXXXXXXXeX
XXeXXXXXXXX
XXXXXXXXXXX
XXXwXXXXXXX
XXXXXqqXXXX
XXXXXXXXXWX
XXXXXXXXXXX
XXXXWXXEXXX
XXXQXXXXXXX
XXXXXXXXXXX
qXXXXXXXXXq
XwXXXXXXXXX
XXXwXXXXXeX
XXXXXrXXXXX
