XXXXXfXXXXX
XXXXXXXXXXX
XXXXQXXXXXX
XXXXXqqXXXQ
XXXXXXXXXQX
QQQQXXXXQXX
XXXXXXXQXXX
XXXXQQQXXXX
XXXXXXXXXWX
wXXXXXXXXXX
XqXXqqXXXXX
XXXXXXXXXXX
XXXXXXQQQQQ
qqqqqXXXXXX
XXXXXrXXXXX
