XXXXXfXXXXX
XXQXXXXQXXX
XXXXXXXXXXX
XXqXXXXwXXX
XXXXXXXXXXX
XXXXXXXXXXX
XXeXXXXwXXX
XXXXXXXXXXX
XXXXXXXXXXX
XXwXXXXwXXX
XXXXXXXXXXX
XXXXXXXXXXX
XXeXXXXWXXX
XXXXXXXXXXX
XXXXXrXXXXX
